32
WWWWWG.W
WWWWWWLW
WW.||..S
WW|W|W..
WW..E||W
KW|W|W.W
.....E.W