43
W.S.WWW
W***WWW
...KWWW
W_2..WW
WEW**..
W..*.EW
WWWWL*.
WWWW.GW