33
WWWWGWWWW
WWW...WWW
WWW*L*WWW
W*W*..W.W
*..***..K
.***..**.
WS.*..*.W