23
SWK.*WWW
.*|$.L.W
*.*.**.G
.*.*.**.
W.*.*.WW